S 1 1 1 1 1 1 1 1 1
1 X 1 X 1 1 1 X 1 1
1 1 1 1 1 2 2 1 1 1
1 1 1 X 1 1 1 1 X 1
1 1 D 1 1 1 1 1 1 1
1 X 1 1 1 1 X 1 1 1
1 1 1 1 X 1 1 1 1 1
1 1 2 1 1 1 1 1 1 1
1 1 1 X 1 1 1 1 1 1
1 1 1 1 1 1 1 1 1 G