S 1 1 1 G
1 X 2 1 1
1 1 1 X 1
X 1 3 1 1
1 1 1 1 1